###############################
#           #   #             #
##### ####### # ##### # # #####
# #   #   #   # # #   # #   # #
# ### # ### # ### # ####### # #
#         # #     #       # # #
### ### ### ##### # ######### #
#   #   #   # # #             #
####### ### # # ### ####### ###
#     # #     #         #     #
### # # # ######### ####### ###
#   #       # #           #   #
####### # ### ### # # #########
# # # # #     # # # #   # # # #
# # # ##### ### # ####### # # #
#   # #     # # # #   # #     #
# ### ##### # # # # ### # # # #
# #       #   #   # # #   # # #
# ##### ####### # # # ### #####
#   #           # # # #       #
### ### # ### ##### # # # #####
# #     #   # #     #   # #   #
# # ### ##### # ### # # ##### #
#     #     # #   #   #       #
# # # # ### ### ### ### #######
# # # # #     # # #   # # # # #
# ##### ####### # # ### # # # #
#   #     #       #   #       #
### # # ### ### # # # # # ### #
#   # #     #   # # # # #   # #
###############################